111111111111
101010E01011
1C01010C0C01
10C0C010C0C1
1C010C0C0101
10101010C011
1C0101010C01
1010101010C1
1C01010C0101
10C01010C011
110C0P0C0101
111111111111