1111111
1CCCCE1
10CCC01
100CC01
1P00C01
1111111