1111111
1CCECC1
1CCCCC1
1CCCCC1
1CCPCC1
1111111