1111111111111111111111111111111111
1E000000000000000000C1000000000001
101001010010000010100100R000010111
101001U01D1010100010010000L0010101
1P0000000C00C0000000000000000100C1
1111111111111111111111111111111111