111111111
1E0000001
1111111G1
1K1000001
100L001U1
100000001
1P00000C1
111111111