1111111
1111011
10L00C1
1011111
1000RE1
1111P11
1111111