1111111111111
1000100010001
10E0G0K0G0C01
1000100010001
11G111G111G11
1000100010001
10C0G0C0GKCK1
1000100010001
11G111G111G11
1000100010001
1KKKG0K0G0P01
10001000100K1
1111111111111